Coding

TextMate
cmd shift 7	mehrere markierte Zeilen auskommentieren

Shell (Befehls-Interpreter):
cmd t		new window
cmd w		close window

unix-commands (Befehle):
cd			change directory
cd ..		higher level (wechselt zum übergeordneten Ordner)
clear		ctrl+L - löscht den Bildschirminhalt
ls			list directory, Option -l gibt Datei-Informationen an
mkdir		make directory (erstellt neuen ordner)
pwd			tells you where you currently are

touch		create file
rm			remove file


which ruby
rails --version bzw. rails -v

irb			beenden mit exit

Grundunterscheidung: kompilieren, interpretieren

Begriffe:
Objekte		Instanzen von Klassen
Methoden	
Iteratoren	Methoden, die für Schleifen zur Verfügung stehen

Konzepte:
Konvention statt Konfiguration
Migration
concept of layouts - containers for views

Englisch:
appropriate - geeignet
arbitrary - beliebig
assign - zuteilen; assignment - Zuweisung
available - verfügbar
assumption - Voraussetzung, Annahme
bootstrap - Startprogramm, laden
bottom - untere, Boden, Grund
branch - verzweigen; Sparte
clone - nachbilden
commit - begehen, übergeben, sich verpflichten
compile - erstellen, übersetzen
confined - begrenzt
detach - trennen, ablösen
dispatch - verschicken
forge - formen, erfinden (Schmiede)
fork - sich verzweigen; Aufspaltung, Gabel
framework - Rahmen, (Programmier-)Gerüst
instantiate - ein Exemplar erzeugen
issue - erstellen, herausgeben
merge - verbinden
migrate - umziehen
persist - andauern, bestehen bleiben
proper - richtig
rake - harken, einstecken, einheimsen
receive - bekommen
refactoring - überarbeiten
remote - (weit) entfernt
render - machen, berechnen und ausgeben
repository - Aufbewahrungsort
request - Anfrage
scaffold - Gerüst
scope - Geltungsbereich
submit - vorlegen, abschicken
supply - liefern
swap - tauschen
take advantage - den Vorteil nutzen
template - Vorlage
tie - binden
unique - einzigartig, einmalig
unless - wenn nicht, außer
yield - liefern; Inhalt

CRUD (Create, Read, Update, Destroy)


new			erstellt ein neues leeres Objekt, ruft die Methode "initialize" auf
generate	

scaffold: 1. the command, 2. the model name and related db table; pluralization/naming conventions, 3. attributes and types)? What are migrations and when do you need to do them, why?

relationship of HTML and Rails
what part of views is HTML
Embedded Ruby (ERB)
How does this relate to MVC (models and controllers control the logic of dynamically generating HTML, or views)?

routes

Sprachkonzepte
imperative Sprache
funktionale Sprache
